11111111
1P011001
11010101
100E0001
10C00001
11111111
