1111111111111
10010000C0001
100E011111001
1P00110000001
1111111111111
