111111111
1000001C1
100010E01
1P0000101
111111111